10
120000333
11
120002000
12
120004000
13
120008000
20
120000333
21
120002000
22
120004000
23
120008000
30
120000333
31
120002000
32
120004000
33
120008000
40
120000333
41
120002000
42
120004000
43
120008000
50
120000333
51
120002000
52
120004000
53
120008000
60
120000333
61
120002000
62
120004000
63
120008000
70
120000333
71
120002000
72
120004000
73
120008000
81
120002000
82
120004000
83
120008000
90
120000333
91
120002000
92
120004000
93
120008000
100
120000333
110
120000333
120
120000333
121
120002000
122
120004000
130
120000333
131
120002000
132
120004000
140
120000333
141
120002000
142
120004000
150
120000333
151
120002000
152
120004000
160
120000333
161
120002000
162
120004000
170
120000333
171
120002000
172
120004000
180
120000333
181
120002000
182
120004000
190
120000333
191
120002000
192
120004000
200
120000333
201
120002000
202
120004000
210
120000333
211
120002000
212
120004000
220
120000333
221
120002000
222
120004000
230
120000333
231
120002000
232
120004000

