11
120002000
12
120004000
13
120008000
21
120002000
22
120004000
23
120008000
31
120002000
32
120004000
33
120008000
41
120002000
42
120004000
43
120008000
51
120002000
52
120004000
53
120008000
61
120002000
62
120004000
63
120008000
71
120002000
72
120004000
73
120008000
81
120002000
82
120004000
83
120008000
91
120002000
92
120004000
93
120008000
121
120002000
122
120004000
131
120002000
132
120004000
141
120002000
142
120004000
151
120002000
152
120004000
161
120002000
162
120004000
171
120002000
172
120004000
181
120002000
182
120004000
191
120002000
192
120004000
201
120002000
202
120004000
211
120002000
212
120004000
221
120002000
222
120004000
231
120002000
232
120004000